0000000000000
0202020202020
0202020202020
0202026202020
0202020202020
0000020200000
6022000002206
0000020200000
0202020202020
0202020202020
0202000002020
0000000000000